{
    "layout": [
        [3, 3, 3, 3, 3, 3, 3, 3, 3, 3, 3, 3, 3, 3, 3, 3, 3, 3, 3, 3, 3, 3, 3, 3, 3],
        [3, 1, 5, 1, 1, 1, 5, 1, 5, 1, 1, 1, 1, 5, 1, 1, 1, 1, 1, 5, 1, 1, 1, 5, 3],
        [3, 1, 5, 1, 5, 1, 5, 1, 1, 1, 5, 5, 1, 1, 1, 5, 5, 5, 1, 5, 1, 5, 1, 1, 3],
        [3, 1, 5, 1, 5, 1, 5, 1, 5, 5, 1, 1, 5, 5, 5, 1, 1, 5, 1, 5, 1, 5, 5, 1, 3],
        [3, 1, 1, 1, 5, 1, 5, 1, 5, 1, 1, 1, 1, 1, 1, 1, 1, 5, 1, 5, 1, 5, 1, 1, 3],
        [3, 5, 5, 5, 5, 1, 5, 1, 5, 1, 5, 5, 5, 5, 5, 5, 1, 5, 1, 1, 1, 5, 1, 5, 3],
        [3, 1, 1, 1, 1, 1, 5, 1, 5, 1, 1, 1, 1, 1, 1, 5, 1, 5, 5, 5, 5, 5, 1, 1, 3],
        [3, 1, 5, 5, 5, 5, 5, 1, 5, 5, 5, 5, 5, 5, 1, 5, 1, 1, 1, 1, 1, 1, 1, 1, 3],
        [3, 1, 1, 1, 1, 1, 1, 1, 5, 1, 1, 1, 1, 1, 1, 5, 5, 5, 5, 5, 5, 5, 5, 5, 3],
        [3, 5, 5, 5, 5, 5, 5, 5, 5, 1, 5, 1, 5, 5, 5, 1, 1, 1, 1, 1, 1, 1, 1, 1, 3],
        [3, 1, 5, 5, 1, 1, 1, 1, 1, 1, 1, 5, 1, 1, 1, 1, 5, 5, 5, 5, 5, 5, 5, 1, 3],
        [3, 1, 1, 1, 1, 1, 5, 5, 5, 5, 5, 1, 1, 5, 5, 5, 1, 1, 1, 1, 1, 1, 1, 1, 3],
        [3, 1, 5, 5, 5, 5, 5, 1, 5, 1, 1, 1, 5, 1, 1, 1, 1, 5, 1, 1, 5, 5, 5, 5, 3],
        [3, 1, 1, 1, 1, 1, 1, 1, 1, 1, 5, 5, 1, 1, 1, 5, 5, 1, 5, 1, 5, 1, 1, 1, 3],
        [3, 5, 5, 5, 5, 5, 5, 5, 5, 5, 1, 1, 1, 5, 5, 1, 5, 1, 1, 5, 5, 1, 5, 1, 3],
        [3, 1, 1, 1, 5, 1, 5, 5, 1, 1, 1, 5, 5, 1, 1, 1, 1, 1, 5, 1, 1, 1, 1, 1, 3],
        [3, 1, 5, 1, 5, 1, 1, 1, 1, 5, 5, 1, 1, 1, 5, 5, 1, 1, 5, 1, 1, 1, 5, 1, 3],
        [3, 1, 5, 1, 1, 5, 5, 1, 5, 1, 1, 1, 5, 5, 1, 1, 1, 5, 1, 1, 5, 5, 5, 1, 3],
        [3, 1, 1, 5, 1, 1, 5, 1, 1, 1, 5, 5, 5, 1, 1, 5, 5, 1, 1, 5, 1, 5, 1, 1, 3],
        [3, 5, 1, 1, 5, 1, 5, 5, 5, 5, 1, 1, 1, 1, 5, 5, 1, 1, 5, 1, 1, 1, 1, 5, 3],
        [3, 1, 5, 1, 5, 1, 1, 1, 5, 1, 1, 1, 5, 5, 1, 1, 1, 5, 1, 1, 5, 5, 5, 1, 3],
        [3, 1, 1, 1, 5, 5, 5, 1, 1, 1, 5, 5, 1, 1, 1, 1, 5, 5, 1, 5, 1, 1, 1, 1, 3],
        [3, 1, 5, 5, 1, 1, 1, 5, 5, 5, 1, 1, 1, 5, 5, 5, 5, 1, 1, 5, 1, 5, 1, 5, 3],
        [3, 1, 1, 1, 1, 5, 1, 1, 1, 1, 1, 5, 5, 1, 1, 1, 1, 1, 1, 1, 1, 5, 1, 1, 3],
        [3, 3, 3, 3, 3, 3, 3, 3, 3, 3, 3, 3, 3, 3, 3, 3, 3, 3, 3, 3, 3, 3, 3, 3, 3]
    ],
    "player_position": [1, 1],
    "npc_positions": [[1, 2], [8, 9], [3, 3], [22, 4]],
    "item_positions": [[1, 1], [3, 1], [5, 6], [7, 8]]
 
}